WWWWWWWWWWWWWWWWWWWWWWWWWWWWWWWWWWWWWWWWWWWWWWWWWW
WWWWWWWWWWWWWWWWWWWWWWWWWWWWWWWWWWWWWWWWWWWWWWWWWW
WWWWWWWWWWWWWWWWWWWWWWWWWWWWWWWWWWWWWWWWWWWWWWWWWW
WWWWWWWWWWWWWWWWWWWWWWWWWWWWWWWWWWWWWWWWWWWWWWWWWW
WWWWWWWWWWWWWWWWWWWWWWWWWWWWWWWWWWWWWWWWWWWWWWWWWW
WWWWWWWWWWWWWWWWWWWWWWWWWWWWWWWWWWWWWWWWWWWWWWWWWW
WWWWWWWWWWWWWW---------------------WWWWWWWWWWWWWWW
WWWWWWWWWWWWWW---------------------WWWWWWWWWWWWWWW
WWWWWWWWWWWWWWOOWWW------------WWOOWWWWWWWWWWWWWWW
WWWWWWWWWWWWWWOOWWW------------WWOOWWWWWWWWWWWWWWW
WWWWWWWWWWWW------WW---------WW------WWWWWWWWWWWWW
WWWWWWWWWWWX------XW----G----WX------XWWWWWWWWWWWW
WWWWWWWWWW----------WW-----WW----------WWWWWWWWWWW
WWWWWWWWWX----------XW-----WX----------XWWWWWWWWWW
WWWWWWWW--------------WW-WW--------------WWWWWWWWW
WWWWWWWW--------------XWWWX--------------WWWWWWWWW
WWWWWWWX----------------W----------------XWWWWWWWW
WWWWWW------------------X------------------WWWWWWW
WWWWWW-------------------------------------WWWWWWW
WWWWWW-------------------------------------WWWWWWW
WWWWWW-------------------------------------WWWWWWW
WWWWWW-------------------------------------WWWWWWW
WWWWWW-------------------------------------WWWWWWW
WWWWWW-------------------------------------WWWWWWW
WWWWWWWX---------------------------------XWWWWWWWW
WWWWWWWW---------------------------------WWWWWWWWW
WWWWWWWWWX-----------------------------XWWWWWWWWWW
WWWWWWWWWW-----------------------------WWWWWWWWWWW
WWWWWWWWWWWX-------------------------XWWWWWWWWWWWW
WWWWWWWWWWWW-------------------------WWWWWWWWWWWWW
WWWWWWWWWWWWWX---------------------XWWWWWWWWWWWWWW
WWWWWWWWWWWWWW---------------------WWWWWWWWWWWWWWW
WWWWWWWWWWWWWWWX-----------------XWWWWWWWWWWWWWWWW
WWWWWWWWWWWWWWWW-----------------WWWWWWWWWWWWWWWWW
WWWWWWWWWWWWWWWWWX-------------XWWWWWWWWWWWWWWWWWW
WWWWWWWWWWWWWWWWWW-------------WWWWWWWWWWWWWWWWWWW
WWWWWWWWWWWWWWWWWWWX---------XWWWWWWWWWWWWWWWWWWWW
WWWWWWWWWWWWWWWWWWWW---------WWWWWWWWWWWWWWWWWWWWW
WWWWWWWWWWWWWWWWWWWWWX-----XWWWWWWWWWWWWWWWWWWWWWW
WWWWWWWWWWWWWWWWWWWWWW-----WWWWWWWWWWWWWWWWWWWWWWW
WWWWWWWWWWWWWWWWWWWWWWWWOWWWWWWWWWWWWWWWWWWWWWWWWW
WWWWWWWWWWWWWWWWWWWWWWWWOWWWWWWWWWWWWWWWWWWWWWWWWW
W------------------------------------------------W
W---------------------------XWWWWWWWWWWWWWWWWWWWWW
W---------------------------XWWWWWWWWWWWWWWWWWWWWW
W---------------------------XWWWWWWWWWWWWWWWWWWWWW
W--------WWWWWWW---------------------------------W
W--------WWWWWWW-----------------------------B---W
W--S-----WWWWWWW---------------------------------W
WWWWWWWWWWWWWWWWWWWWWWWWWWWWWWWWWWWWWWWWWWWWWWWWWW