WWWWWWWWWWWWWWWWWWWWWWWWWWWWWWWWWWWWWWWWWWWWWWWWWW
WG-----------------------------------------------W
W------------------------------------------------W
W------------------------------------------------W
W------------------------------------------------W
W------------------------------------------------W
W-----------------------X------------------------W
W------------------------------------------------W
W----------X----------------------X--------------W
W------------------------------------------------W
W-------X------------------------------X---------W
W------------------------------------------------W
W-----------------------------------------X------W
W------------------------------------------------W
W-----------------X----------------------XX------W
W------------------------XX----------------------W
W------------------------------------------------W
W-----------------X------------------------------W
W------------------------------------------------W
W---------------------------------------X--------W
W------------------------------------------------W
W------------------------------------------------W
W-----------------X------------------------------W
W------------------------------------------------W
W------------------------------------------------W
W--------------------------------------------B---W
W------------------------------------------------W
W------------------------------------------------W
W------------------------------------X-----------W
W------------X-----------------------------------W
W------------------------------------------------W
W--------------------X--------------------X------W
W------------------------------------------------W
W------------------------------------------------W
W----------------X----------------------X--------W
W------------------------------------------------W
W------------------------------------------------W
W------------------------------------------------W
W------------------------------------------------W
W---------------------X----------------X---------W
W------------------------------------------------W
W------------------------------------------------W
W------------------------------------------------W
W-----------------X------------------------------W
W--------------X-------------------X-------------W
W------------------------------------------------W
W------------------------------X-----------------W
W------------------------------------------------W
W---S--------------------------------------------W
WWWWWWWWWWWWWWWWWWWWWWWWWWWWWWWWWWWWWWWWWWWWWWWWWW