WWWWWWWWWWWWWWWWWWWWWWWWWWWWWWWWWWWWWWWWWWWWWWWWWW
WWWWWWWWWWWWWWWWWWWWWWWWWWWWWWWWWWWWWWWWWWWWWWWWWW
WW----------------------------------------------WW
WW---S--------------------------------------WWWWWW
WW------------------------------------------WWWWWW
WW----------------------------------------------WW
WWWWWW-------------WWWWWWWWWWWWWWWWWWWWWWW--WWWWWW
WWWWWW-------------WWWWWWWWWWWWWWWWWWWWWWW--WWWWWW
WWWWWW------B------WWW----------------------WWWWWW
WWWWWW------------------------------WWWWWW--WWWWWW
WW--------WWWWWWWWWWWWWWWWWWWWWWWWWWWWWWWWWWWWWWWW
WW-------------------------------------X--------WW
WW------------------------------------X---------WW
WW-----------------------------------X----------WW
WW----------------------------------X-----------WW
WW---------------------------------X------------WW
WW--------------------------------X-------------WW
WW-------------------------------X--------------WW
WW------------------------------X---------------WW
WW-----------------------------X----------------WW
WW----------------------------X-------------WWWWWW
WW------------------------------------------WWWWWW
WW----------------------------------------------WW
WWWWWWOOOOOOOOOOOOOOOOOOOOOOOOOOOOOOWWWWWWWWWWWWWW
WWWWWWOOOOOOOOOOOOOOOOOOOOOOOOOOOOOOWWWWWWWWWWWWWW
WWWWWWOOOOOOOOOOOOOOOOOOOOOOOOOOOOOOWWWWWWWWWWWWWW
WWWWWWOOOOOOOOOOOOOOOOOOOOOOOOOOOOOOWWWWWWWWWWWWWW
WW----------------------------------------------WW
WW----------------------------------------------WW
WW----------------------------------------------WW
WW----------------------------------------------WW
WW----------------------------------------------WW
WW----------------------------------------------WW
WW----------------------------------------------WW
WW----------------------------------------------WW
WW----------------------G-----------------------WW
WW----------------------------------------------WW
WW----------------------------------------------WW
WW----------------------------------------------WW
WW-----------------WWWWWWWWWWWWW----------------WW
WW-----------------WWWWWWWWWWWWW----------------WW
WW-----------------WWWWWWWWWWWWW----------------WW
WW----------------------------------------------WW
WW----------------------------------------------WW
WW----------------------------------------------WW
WW----------------------------------------------WW
WW----------------------------------------------WW
WWWWWWWWWWWWWWWWWWWWWWWWWWWWWWWWWWWWWWWWWWWWWWWWWW
WWWWWWWWWWWWWWWWWWWWWWWWWWWWWWWWWWWWWWWWWWWWWWWWWW