WWWWWWWWWWWWWWWWWWWWWWWWWWWWWWWWWWWWWWWWWWWWWWWWWW
W---------------------------X--------WWWWWWWWWWWWW
W--S------------------------X--------WWWWWWWWWWWWW
WWWWWWWWWWWWWWWWWWWWWWWOOOWWWWWWWWWWWWWWWWWWWWWWWW
W---X---------------------WWWWWWWWWWWWWWWWWWWWWWWW
W---X--------------------------------------------W
W--------------------------------------------X---W
W------WWWWWWWWWWWWWWWWWWWWWWWW------------------W
W------------------------------------WWWWWW--B---W
W------------------------------------WWWWWW------W
WWWWWWWWWWWWWWWWWOOOOOWWWWWWWWWWWWWWWWWWWWWWWWWWWW
WWWWWWWWWWWWWWWWW-----WWWWWWWWWWWWWWWWWWWWWWWWWWWW
WWWWWWWWWWWWWWWWW--X--WWWWWWWWWWWWWWWWWWWWWWWWWWWW
WWWWWWWWWWWWWWWWW----------WWWWWWWWWWWWWWWWWWWWWWW
WWWWWWWWWWWWWWWWW----------WWWWWWWWWWWWWWWWWWWWWWW
WWWWWWWWWWWWWWWWWWWWWW-----WWWWWWWWWWWWWWWWWWWWWWW
WWWWWWWWWWWWWWWWWWWWWW-----WWWWWWWWWWWWWWWWWWWWWWW
WWWWWWWWWWWWWWWWWWWWWW-----WWWWWWWWWWWWWWWWWWWWWWW
WWWWWWWWWWWWWWWWW---------------WWWWWWWWWWWWWWWWWW
WWWWWWWWWWWWWWWWW--X---------X--WWWWWWWWWWWWWWWWWW
WWWWWWWWWWWWWWWWW---------------WWWWWWWWWWWWWWWWWW
WWWWWWWWWWWWWWWWWWWWWW-----WWWWWWWWWWWWWWWWWWWWWWW
WWWWWWWWWWWWWWWWWWWWWW-----WWWWWWWWWWWWWWWWWWWWWWW
WWWWWWWWWWWWWWWWWWWWWW-----WWWWWWWWWWWWWWWWWWWWWWW
WWWWWWWWWWWWWWWWW---------------WWWWWWWWWWWWWWWWWW
WWWWWWWWWWWWWWWWW--X---------X--WWWWWWWWWWWWWWWWWW
WWWWWWWWWWWWWWWWW---------------WWWWWWWWWWWWWWWWWW
WWWWWWWWWWWWWWWWWWWWWW-----WWWWWWWWWWWWWWWWWWWWWWW
WWWWWWWWWWWWWWWWWWWWWW-----WWWWWWWWWWWWWWWWWWWWWWW
WWWWWWWWWWWWWWWWWWWWWW-----WWWWWWWWWWWWWWWWWWWWWWW
WWWWWWWWWWWWWWWWW---------------WWWWWWWWWWWWWWWWWW
WWWWWWWWWWWWWWWWW--X---------X--WWWWWWWWWWWWWWWWWW
WWWWWWWWWWWWWWWWW---------------WWWWWWWWWWWWWWWWWW
WWWWWWWWWWWWWWWWWWWWWW-----WWWWWWWWWWWWWWWWWWWWWWW
WWWWWWWWWWWWWWWWWWWWWW-----WWWWWWWWWWWWWWWWWWWWWWW
WWWWWWWWWWWWWWWWWWWWWWOOOOOWWWWWWWWWWWWWWWWWWWWWWW
W--------------------------WWWWWWWWWWWWWWWWWWWWWWW
W--------------------------WWWWWWWWWWWWWWWWWWWWWWW
W----------------------------XWWWWWWWWWWWWWWWWWWWW
W-----------WWW--------------XWWWWWWWWWWWWWWWWWWWW
W-----------WWW--------------XWWWWWWWWWWWWWWWWWWWW
W-----------WWW--------------XWWWWWWWWWWWWWWWWWWWW
W------------XW-----------WWWWWWWWWWWWWWWWWWWWWWWW
W------------XW-----------WWWWWWWWWWWWWWWWWWWWWWWW
W------------XW-----------WWWWWWWWWWWWWWWWWWWWWWWW
W-----------WWWWWWWWWWWW--WWWWWWWWWWWWWWWWWWWWWWWW
W-------------------------WWWWWWWWWWWWWWWWWWWWWWWW
W-----------------------G-WWWWWWWWWWWWWWWWWWWWWWWW
W-------------------------WWWWWWWWWWWWWWWWWWWWWWWW
WWWWWWWWWWWWWWWWWWWWWWWWWWWWWWWWWWWWWWWWWWWWWWWWWW