WWWWWWWWWWWWWWWWWWWWWWWWWWWWWWWWWWWWWWWWWWWWWWWWWW
WWWWWWWWWWWWWWWWWWWWWWWWWWWWWWWWWWWWWWWWWWWWWWWWWW
WW----------------------------------------------WW
WW-------WWW-----X--------------------------WWWWWW
WW-------WW---------------------------------WWWWWW
WW-----------------------G----------------------WW
WWWWWW------------------------------WWWWWW--WWWWWW
WWWWWW---------------------------------WWW--WWWWWW
WWWWWW------B------WWW----------------------WWWWWW
WWWWWW------------------------------WWWWWW--WWWWWW
WW----------------------------------------------WW
WW-----------X---------------------X------------WW
WW-----------X---X------------------------------WW
WW----------------------------------------------WW
WW----------------------------------------------WW
WW----------------------------------------------WW
WW----------------------------------------------WW
WW----------------------------------------------WW
WW----------------------------------------------WW
WW----------------------------------------------WW
WW-------WWW--------------------------------WWWWWW
WW-------WW---------------------------------WWWWWW
WW----------------------------------------------WW
WWWWWW------------------------------WWWWWW--WWWWWW
WWWWWW-------------WWW----------------------WWWWWW
WWWWWW-------------WWW----------------------WWWWWW
WWWWWWWWWWWWWWWWWWWWWWWWWWWWWWWWWWWWWWWWWWWWWWWWWW
WW----------------------------------------------WW
WW----------------------------------------------WW
WW----------------------------------------------WW
WW----------------------------------------------WW
WW----------------------------------------------WW
WW----------------------------------------------WW
WW---------------------------------S------------WW
WW----------------------------------------------WW
WW----------------------------------------------WW
WW----------------------------------------------WW
WW----------------------------------------------WW
WW----------------------------------------------WW
WW-----------------WWWWWWWWWWWWW----------------WW
WW-----------------WWWWWWWWWWWWW----------------WW
WW-----------------WWWWWWWWWWWWW----------------WW
WW----------------------------------------------WW
WW----------------------------------------------WW
WW----------------------------------------------WW
WW----------------------------------------------WW
WW----------------------------------------------WW
WWWWWWWWWWWWWWWWWWWWWWWWWWWWWWWWWWWWWWWWWWWWWWWWWW
WWWWWWWWWWWWWWWWWWWWWWWWWWWWWWWWWWWWWWWWWWWWWWWWWW