11111111111111111111111111111111111111111111111111
11111111111111111111111111111111111111111111111111
11000000000000000000000000000000000000000000000011
11000000011100000000000000000000000000000000111111
11000000011000000000000000000000000000000000111111
11000000000000000000000000000000000000000000000011
11111100000000000000000000000000000011111100111111
11111100000000000000000000000000000000011100111111
11111100000000000001110000000000000000000000111111
11111100000000000000000000000000000011111100111111
11000000000000000000000000000000000000000000000011
11000000000000000000000000000000000000000000000011
11000000000000000000000000000000000000000000000011
11000000000000000000000000000000000000000000000011
11000000000000000000000000000000000000000000000011
11000000000000000000000000000000000000000000000011
11000000000000000000000000000000000000000000000011
11000000000000000000000000000000000000000000000011
11000000000000000000000000000000000000000000000011
11000000000000000000000000000000000000000000000011
11000000011100000000000000000000000000000000111111
11000000011000000000000000000000000000000000111111
11000000000000000000000000000000000000000000000011
11111100000000000000000000000000000011111100111111
11111100000000000001110000000000000000000000111111
11111100000000000001110000000000000000000000111111
11111100000000000000000000000000000011111100111111
11000000000000000000000000000000000000000000000011
11000000000000000000000000000000000000000000000011
11000000000000000000000000000000000000000000000011
11000000000000000000000000000000000000000000000011
11000000000000000000000000000000000000000000000011
11000000000000000000000000000000000000000000000011
11000000000000000000000000000000000000000000000011
11000000000000000000000000000000000000000000000011
11000000000000000000000000000000000000000000000011
11000000000000000000000000000000000000000000000011
11000000000000000000000000000000000000000000000011
11000000000000000000000000000000000000000000000011
11000000000000000000000000000000000000000000000011
11000000000000000000000000000000000000000000000011
11000000000000000000000000000000000000000000000011
11000000000000000000000000000000000000000000000011
11000000000000000000000000000000000000000000000011
11000000000000000000000000000000000000000000000011
11000000000000000000000000000000000000000000000011
11000000000000000000000000000000000000000000000011
11111111111111111111111111111111111111111111111111
11111111111111111111111111111111111111111111111111